##########
#   #    #
#   #    #
#   ### ##
#        #
#####   ##
#  ##@  ##
#  ###  ##
##       #
##########
